8 8
. . . . . . . @
@ . @ . . . . .
@ @ . . . @ . .
. @ . . . . @ .
. . @ . . . . .
. . . . . . . .
. @ @ @ . . . .
. . . . . . . .
7
1 5 7 0
4 0 2 2
0 4 4 3
3 0 7 6
6 4 3 4
0 3 4 0
6 0 0 5
