10 10
. . . . . . . . . .
. . . . . . . . . .
. . . . . . . . . .
. . . . . . . . @ .
. . . . . . @ . . .
. . @ . . . . . . .
. . . . . . . . . .
. . . . . . . @ . .
. . . . . . . @ . .
. . . . . . . . . .
12
0 8 6 3
9 8 4 1
5 8 7 5
7 9 1 5
5 5 4 0
9 6 6 6
8 1 0 1
9 2 5 3
6 9 3 1
9 1 7 3
8 0 4 8
5 4 6 8
