10 10
. . . @ . . . . @ .
. . . . . . . . . .
. . . @ . . . @ . .
. . . . . . . . . .
. . . . . . . . . .
@ . . . @ . . . @ .
. @ . . . . . . . .
. . . @ @ @ . @ . .
. . . . . . . . . .
. . . . . . @ . @ .
5
5 3 1 1
7 9 6 0
0 2 1 8
0 0 2 6
5 1 2 2
