8 8
. . @ . . . . .
. . . . . @ . .
. . . . . . . .
. . . @ . . . .
. . . . . . @ .
. . . . . . . .
. . . . . @ . .
. . . . . . . @
8
1 2 6 2
7 4 6 3
6 1 5 1
3 1 2 3
2 0 5 7
6 0 1 1
0 6 7 4
2 5 5 2
